Spec	Color
Bashing	Neutral
Finesse	Neutral
Anarchy	Red
Blood	Red
Fire	Red
Balance	Green
Feral	Green
Growth	Green
Demonology	Black
Disease	Black
Necromancy	Black
Law	Blue
Peace	Blue
Truth	Blue
Discipline	White
Ninjutsu	White
Strength	White
Past	Purple
Present	Purple
Future	Purple